bb.......................b
.....b...................b
.........................b
bbbbbbbbbbbbbbbbbbbbbbbbbb
.........................b
.........................b
.........................b
.........................b
.........................b
p.....b..................b
.........................b
.........................b
bbbbbbbbbbbbbbbbbbbbbbbbbb
.........................b